***************************************************************
*.........................*...................................*
*.........................*...................................*
*.........................*...................................*
*.........................*...................................*
*.........................*...................................*
***************************************************************
*.........................*...................................*
*.........................*...................................*
*.........................*...................................*
*.........................*...................................*
*.........................*...................................*
***************************************************************
*.........................*...................................*
*.........................*...................................*
*.........................*...................................*
*.........................*...................................*
*.........................*................*..................*
*.........................*................*..................*
***************************************************************
